a pertar -- apertar
a quando -- aquando
à quem -- aquém
absti-me -- abstive-me
acelarar - acelerar, aclarar
acêrca -- acerca
ácerca -- acerca, à cerca, há cerca
acimas -- acima, acimar
aério -- aéreo
afizeram-se -- afizeram-se, fizeram-se
aformoseamento -- aformosamento
agricolas -- agrícolas
agua - agua, água
ainge -- atinge
alca -- alça, cala
algerós -- algeroz
alguima -- alguma
alertas -- alertas, alerta
alem -- além
alguem -- alguém
alivio -- alivio, alívio
alí -- ali
alteado -- alteado, alterado
altruismo -- altruísmo
altruista -- altruísta
amafado -- afamado, anafado
amendoas -- amêndoas
America -- América
Americas -- Américas
Angela -- Ângela
anal -- anal, mal, a mal
Angelo -- Ângelo
angustia -- angustia, angústia
anornalia -- anomalia
ansia -- ânsia, anseia
anti-histaminicos -- anti-histamínicos
anu -- a nu
anus -- ânus, anos
apaciente -- a paciente, apascente
aparerecem -- aparecem
apetititosas -- apetitosas
apezar -- apesar
apoz -- após
aroz -- arroz
arteria -- artéria
assente -- assente, assento, acente
assento -- assento, acento, assente,
assiomático -- axiomático, assomático
atão -- então
atraves -- através, as traves, atravesse, atravessa
atraz -- atrás, traz
auspicio -- auspicio, auspício
auspicios -- auspícios
auto-dominio -- autodomínio
autopsia -- autopsia, autópsia
auxilio - auxilio, auxílio
avido -- ávido, havido
ângelical -- angelical
bacteria -- bactéria
bébé -- bebé, bebê
bedidas -- bebidas, medidas
beneficio -- beneficio, benefício
beneficios -- benefícios
bemfazejas -- benfazejas
bienio -- biénio, biênio
bismo -- abismo
bocal -- bocal, bucal, boçal
bolir -- bulir, bolar
bolsar -- bolçar, bolsa
bonus -- bónus
bucal -- bucal, bocal
bravos -- bravos, braços
cad -- cada
caimbras -- câimbras
cairam -- caíram, caírem, caiam
caisquer -- quaisquer
California -- Califórnia
calvice -- calvície
camara -- câmara, chamara
campaínha -- campainha
campião -- campeão
cane -- cone, acne
caricias -- carícias
carie -- carie, cárie
carna -- carne, cana
cassa -- cassa, caça
cassete -- cassete, cacete
causadíaco -- causídico
centimetro -- centímetro
cercas -- cercas, acercas, cerdas, certas
cerimonia -- cerimonia, cerimónia
cetas -- certas, setas
ceu -- céu, seu
chava -- chave, chama
cheínho -- cheiinho
chines -- chinês
cientifica -- científica
circulo -- circulo, círculo
circunstancias -- circunstâncias, circunstancial
ciume -- ciúme
clinica -- clínica
clinico -- clínico
cociente -- quociente
Colombia -- Colômbia
come-mos -- come-mos, comemos
comercio -- comércio, comerceio
comprendeu -- compreendeu
comprindo -- comprido, cumprindo
comprimento -- comprimento, cumprimento
condoida -- condoída
conferencia -- conferencia, conferência
cônjugue -- cônjuge
considrando -- considerando
consporcar -- conspurcar
consul -- cônsul
constituitivos -- constitutivos
contigua -- continua, contígua
conti-me -- contive-me, conta-me, contei-me, conte-me
continua -- continua, contínua
contunar -- continuar
convivio -- convívio, convivo
cordenar -- coordenar
corpusculo -- corpúsculo
corropio -- corrupio
cuaisquer -- quaisquer
cumprimento -- cumprimento, comprimento
curriculo -- currículo
cutânia -- cutânea
cutânias -- cutâneas
dansar -- dançar
daruma -- dar uma
decada -- decada, década, de cada
declinio -- declínio
defezas -- defesas
deficiencia -- deficiência
degejuar -- desjejuar
deminiu -- diminui
desassocego -- desassossego
descanço -- descanso
descaso -- descaso, descanso
desejaveis -- desejáveis
desembro -- dezembro
desempeno -- desempeno, desempenho
desencandeando -- desencadeando
desenteria -- disenteria
desequilibrio -- desiquilíbrio, desiquilibro
desfeicho -- desfecho
deshonra -- desonra
desiquilibrio -- desiquilíbrio, desiquilibro
desperdicio -- desperdício, desperdiço
dessacar -- dissecar
destroi -- destrói
desulpem -- desculpem
deter-mino -- determino
deteu -- deteve
deviamos -- devíamos
diarréia -- diarreia
dição -- dicção, lição
diente -- doente, diante, ciente, cliente
deferencia -- deferência, diferencia, diferença
diferencia -- diferencia, diferença
diferencia-rem -- diferenciarem
diferência -- diferencia, diferença, deferência
dignatário -- dignitário, signatário
diminuitivo -- diminutivo
discipúlo -- discípulo
discreção -- discrição
dispares -- dispares, díspares
dispensa -- dispensa, despensa
disperdicio -- desperdício, desperdiço
doenca -- doença
domiciliaria -- domiciliária
dominio -- domínio, domino
domino -- domino, dominó, domínio
duzia -- dúzia
edificio -- edifício, edifico
efifício -- edifício
egooismo -- egoísmo
egoista -- egoísta
emcaminhado -- encaminhado
emnora -- embora
emvez -- em vez
enchame -- enxame
enchuto -- enxuto, em chuto
encertar -- encetar, enxertar
enter -- entre
entráva-mos -- entrávamos, entrava-mos
entreteste-te -- entretiveste-te
entumescia -- intumescia, entumecia
enviezado -- enviesado
eo -- e o
eplos -- pelos
equilibrio -- equilíbrio, equilibro
equilibrios -- equilíbrios
ermita -- ermita, eremita, ermida
escaras -- escaras, escarras
esclamar -- exclamar
escuta-la -- escuta-la, escutá-la
escuta-los -- escuta-los, escutá-los
esmo -- esmo, mesmo
esperanca -- esperança
espirito -- espírito
esplendido -- esplêndido
estadio -- estádio, estagio
estagio -- estagio, estágio
establecer -- estabelecer
estatistícos -- estatísticos
esteril -- estéril, Estoril
estrépido --  estrépito
estrira -- estria
estrovar --  estorvar
esvasie -- esvazie
excente -- excelente
exercicio -- exercício, exercito
exercito -- exercito, exército
exercitos -- exércitos
exigencia -- exigência
exita -- excita, hesita
exito -- êxito, hesito, excito
exterminio -- extermínio, extermino
falho -- falho, falso
familia -- família, familiar
familial -- familiar
ferranho -- ferrenho
ficiológico -- fisiológico
fisica -- física
fistulas -- fístulas
flue -- flui
fluido -- fluido, fluído
fôra -- fora
forum --  fórum, forem, foram
gase -- gaze
glandula -- glândula
gordorosas -- gordurosas
graínha -- grainha
gratuíto -- gratuito
higene -- higiene
historia -- historia, história
historias -- historias, histórias
homosexualidade -- homossexualidade
hóstil -- hostil, hóstia
ilheu -- ilhéu
Ilheus -- Ilhéus
impar -- impar, ímpar, limpar
ímpar -- ímpar, impar
impares -- impares, ímpares
importancia -- importância
incarnar -- encarnar
indentificação - identificação, edentação
indepêndencia - independência
India -- Índia
indices - índices
individuo - individuo, indivíduo
índividuo - indivíduo
índivíduo - indivíduo
individuos - indivíduos
índividuos - indivíduos
índivíduos - indivíduos
industria -- industria, indústria
influencia -- influencia, influência
inicia-la -- inicia-la, iniciá-la, inicia-a 
inicio -- inicio, início
intimo -- intimo, íntimo
iris -- íris
irmamente -- irmãmente
juizes -- juízes
juizo -- juízo
laminas -- lâminas
lampeão -- lampião, campeão
lêm -- leem
lençóizinhos -- lençoizinhos
libido -- líbido
líbido -- líbido, líbio
libre -- livre
lider -- líder, lidera
linguaguem -- linguagem
liquido -- liquido, líquido
lititigiosos -- litigiosos
luvas -- luvas, lavas
malefica -- maléfica
mam - mama
mantem -- mantém, mantêm
mantem-se -- mantém-se, mantêm-se
mares -- mares, marés
mascaras -- mascaras, máscaras
materia -- matéria, material
maxiliar -- maxilar
medicas -- medicas, médicas
melhoras -- melhoras, melhores
memos -- memos, menos
meno -- meio
menoes -- menos, menores
metodo -- método
Mexico -- México
mias -- mias, mais, meias
míriade -- miríade
modulo - modulo, módulo
muinto -- muito
multiplas -- múltiplas
munto -- muito
negocio -- negócio, negoceio
ninguem -- ninguém
noticia -- noticia, notícia
obdece -- obedece
obstrue -- obstrui, obstrua
obtem -- obtêm, obtém
obtem-se -- obtêm-se, obtém-se
oficio -- ofício
oranismo -- organismo, onanismo
oras -- oras, horas
orçamentarias -- orçamentarias, orçamentais
organica -- orgânica, organiza
paí, pái -- pai
paízes -- países, pazes
papeis -- papeis, papéis
parcimonia -- parcimónia
pareca -- pareça
parecimento -- aparecimento
páteo -- pátio
patio -- pátio
patria -- pátria
patrio -- pátrio
peia -- peia, pela 
penas -- penas, apenas
pera -- pêra, espera
perconizar -- preconizar
percussor -- precursor
perfumamados -- perfumados
persagiam --  pressagiam
persentido -- pressentido
perstações -- prestações
poça -- poça, possa
pole -- polé, pele
politico -- político
porem -- porem, porém
porisso -- por isso
póro -- poro
poruma - por uma
possar -- passar, possa, possas
preferencia -- preferência
prejuizo -- prejuízo
prejuizos -- prejuízos
presidencia -- presidência
presserverar -- perseverar
prestigio -- prestigio, prestígio
pretesto -- pretexto, protesto
préviamente -- previamente
previdencia -- previdência, providencia
previo -- prévio
principio - principio, princípio
principios - rincípios, principio
primarias - primárias
priveligiado -- privilegiado
proibe -- proíbe
prolema -- problema
proletario -- proletário
promeinentes -- proeminentes
proteina -- proteína, proteica
proteinas -- proteínas, proteicas
proviniente -- proveniente
publico -- publico, público
publicos -- públicos, publico
pular -- pular, polar
pulir -- polir, pular
puncionar -- funcionar
puz -- pus
quarteis -- quartéis
queiremos -- queiramos, queremos
quere-me -- quer-me
quer-lo -- quere-o
quisquer -- quaisquer
quissá -- quiçá
quiz -- quis
rabujento -- rabugento
rádio-amador -- radioamador
raíz -- raiz
raizes -- raízes
redondamento -- redondamente, arredondamento
refelexão -- reflexão
refens -- reféns
refer-se -- refere-se
regimen -- regímen, regime
regorgitar -- regurgitar
reincarnar -- reencarnar
reinvindicar -- reivindicar
relaxamente -- relaxamento
remedia -- remedeia
resa -- reza
residencia -- residência
residuo -- resíduo
restricto -- restrito
reunem -- reúnem
reuno -- reúno
revolucionarias -- revolucionarias, revolucionárias
rezina -- resina, retzina
ridicula -- ridícula
rítimo -- ritmo
rítmo -- ritmo
romaría -- romaria
rossa -- roça, russa
ruimente -- ruimmente
sábado -- sábado, sabido
sabia -- sabia, sábia
saia -- saia, saiamos
saiamos -- saiamos, saíamos
sanguineo -- sanguíneo
Santarem -- Santarém
secrestar -- sequestrar
sedeado -- sediado
selinidade -- senilidade, salinidade
semi-cerrado -- semicerrado
seríam -- seriam
silo -- silo, sido
simultâneamente -- simultaneamente
sindrome -- síndrome, sindroma
sintetisa -- sintetiza
soar -- soar, suar
sores -- soares, Soares, pores
sobestimar -- subestimar
sobrestimar -- subestimar, sobre-estimar
sociadade -- sociedade
soçubrar -- soçobrar
soja -- soja, seja
solo -- solo, sólo, sol
sómente -- somente
sonâmbolo -- sonâmbulo
suavisa -- suaviza
sub-solo --subsolo
subesserviência -- subserviência
substancia -- substancia, substância
substancias -- substancias, substâncias
substituia -- substituía, substitua
substracto -- substrato
sues -- sues, seus
suino -- suíno
superfluo -- supérfluo
supresticioso -- supersticioso
surjir -- surgir
surpreza -- surpresa
taboleiro -- tabuleiro
tábua-rasa -- tábua rasa
tambem -- também
taxi -- táxi
tele-guiado -- teleguiado
tempode -- tempo de
tendencia -- tendência, tendencial
terrivel -- terrível
terum -- ter um
tingir -- tingir, atingir
tnedo -- tendo
tomare -- tomar, tomate, tomares, tomarei
toxico -- tóxico
trafico -- trafico, tráfico
tragetória -- trajetória
tragica -- trágica
trazeira -- traseira
tregeitos -- trejeitos
trousse -- trouxe
turcicolo -- torcicolo
últimamente -- ultimamente
unia -- unia, uma
uníssuno -- uníssono
urano -- Urano, urânio
utero -- útero, Lutero
vaculares -- vasculares
vajem -- vagem, viajem
veu -- véu, viu
viage -- viaje, viagem
viagem -- viagem, viajem
viamos -- víamos
vicera - víscera
vide -- vide, vida, 
viuvo -- viúvo
vizitante -- visitante
voses -- vozes
vozeria -- vozearia
xadresista -- xadrezista
xal -- xale
zenite -- zénite
zoas -- zonas
zoto -- azoto